*_*_*_*_*_*_*_*_*_*_*_*_*_*_*_*_*_*_*_*_*
*_baba_is_you_*_*_*_*_*_*_*_*_*_*_*_*_*_*_*_*_*
*_box_is_pull_*_*_*_*_*_*_*_*_*_*_*_*_*_*_*_*_*
*_flag_is_win_*_*_*_*_*_*_*_*_*_*_*_*_*_*_*_*_*
*_wall_is_stop_*_*_*_*_*_*_*_*_*_*_*_*_*_*_*_*_*
*_*_*_*_*_*_*_*_*_*_*_*_*_*_*_*_*_*_*_*_*
*_*_*_*_*_*_*_*_*_*_*_*_*_*_*_*_*_*_*_*_*
*_-_-_-_-_-_-_-_-_-_-_-_-_-_-_-_-_-_-_-_*
*_-_*_B_*_*_*_*_*_*_*_*_*_*_*_*_*_*_*_-_*
*_-_*_M_*_*_*_*_*_*_*_*_*_*_*_*_*_*_*_-_*
*_-_*_*_*_*_*_*_*_*_*_*_*_*_*_*_*_*_*_-_*
*_-_*_*_*_*_*_*_*_*_*_*_*_*_*_*_*_*_X_-_*
*_-_-_-_-_-_-_-_-_-_-_-_-_-_-_-_-_-_-_-_*
*_*_*_*_*_*_*_*_*_*_*_*_*_*_*_*_*_*_*_*_*
*_*_*_*_*_*_*_*_*_*_*_*_*_*_*_*_*_*_*_*_*
*_*_*_*_*_*_*_*_*_*_*_*_*_*_*_*_*_*_*_*_*
*_*_*_*_*_*_*_*_*_*_*_*_*_*_*_*_*_*_*_*_*
*_*_*_*_*_*_*_*_*_*_*_*_*_*_*_*_*_*_*_*_*
*_*_*_*_*_*_*_*_*_*_*_*_*_*_*_*_*_*_*_*_*
*_*_*_*_*_*_*_*_*_*_*_*_*_*_*_*_*_*_*_*_*
*_*_*_*_*_*_*_*_*_*_*_*_*_*_*_*_*_*_*_*_*
